LAND game Map 50 x 16
Stage #2
CRC-32 66CABCEE

{
#<>############  #############  ##################
#[]            ##             ##               []#
#[]                   $ $                      []#
# []   $$          []%%$%%[]         $$$      [] #
#   [] ^^ []     []         []     []^^^[]$$[]   #
#       ^^  [] []    % $ %    [] []       ^^     #
#    $       [] $$%%%%% %%%%%$$ []               #
#   $$$      []$%%%% $   $ %%%%$[]        $$     #
#  $$$$$   []$ %%% $  $ $  $ %%% $[]  $        $ #
#       $ []  ^%  ^^^^^^^^^^^  %^  []  %12$$12%  #
#[] ^^^^ []    %%1234123412341%%    [] %%%[]%%%  #
#[]       []  $%%%^^^^^^^^^^^%%%$  []     []     #
#[]         [] %%%%% $ $ $ %%%%% []       []     #
#[]        []   $%%%%%%%%%%%%%$   []      []     #
#[]  %1234% [] $$%1$1412341$1%$$ []       []     #
##################################################
}

Legend:
=====================
 # = Solid Wall
 % = Brick Wall
 $ = Chest
 1 = Biomass 1
 2 = Biomass 2
 3 = Biomass 3
 4 = Biomass 4
 ^ = Floor
 [ = Ladder Left
 ] = Ladder Right
 < = Exit Door Left
 > = Exit Door Right
