LAND game Map 50 x 16
Stage #14
CRC-32 73D8E32D

{
#<>############  #############  ##################
#[]  %123412341                 %% $    $  $ $ %%#
#[]^ ^^^^^^^^^^  %12341234123^^^^^^^ []^^^^^^^#  #
#[]  $ $       $ %%%%%%%%%%%%%  $   []%% $ $ $ %%#
#%%%%%%%%%[]  ^^^^^^^^^^^^^^^^^^^^ []%%%%%%%%%#^^#
#$$#  %$%%%[]    %12341234123%    [] # $ $ $ $   #
#    $#[]^^^[]%%%%%%%%%%%%%%%%%%%[] %%%%%%%%%%#^^#
#$$#  []         %12341234123%    []   $ $ $ $   #
#   $ #[] $    []%%%%%$$%%%%%%[]    ^^^^^^^^%%%[]#
#$$#  []     []  $ $ $   $ $ $  []      %123$ %[]#
#          []%%%%%%%%%%[]^^^^^^^^^[]    %%%%%%%[]#
#  #^^^  []%%$ $ $ $ $%[]%%$ $ $ $%%[]      $ %[]#
#$$%   []^^^^^^^^^^^^^^[]^^^^^^^^^^^^^[]    ^^^[]#
#%%  []                                 []     []#
#  []1234123412341234123412341234123412341[]   []#
##################################################
}

Legend:
=====================
 # = Solid Wall
 % = Brick Wall
 $ = Chest
 1 = Biomass 1
 2 = Biomass 2
 3 = Biomass 3
 4 = Biomass 4
 ^ = Floor
 [ = Ladder Left
 ] = Ladder Right
 < = Exit Door Left
 > = Exit Door Right
