LAND game map 48 x 14
Stage #5
                     
01234567890123456789012345678901234567890123456780
1][      CC  BBCC      CCCC        BB  BBCBBCBB][1
2  ][````````BB``      ][][      C BB  ``````][][2
3C ][][      BB      ][BBBB][    ``BBWW    ][][C 3
4 CBB  ][    BB    ][  BBBB  ][    BB    ][     C4
5C BB    ][  BB  ][   CBBBB    ][  BB  ][  CC  C 5
6 CBB      ][  ][      BBBBC     ][BB][         C6
7B BB  CC    ][        BBBB  C     ][          C 7
8 BBB``````  ][````````BBBB````````][    CC     C8
9C BB      ][][][     CBBBB      ][][][        C 9
0  BB    ][      ][    BBBBC   ][      ][    CC C0
1C BB  ][          ][  BBBB  ][          ][    C 1
2 C  ][              ][BBBB][    CC        ][   C2 
3  ][  ``````````  ][  ][][  ][  ``````````  ][  3
4][12341234123412  ][WWWWWWWW][CCB1234123412341WW4
01234567890123456789012345678901234567890123456780

Legend 
=====================
 W    - Stone Wall
 B    - Brick wall
 C    - Chest
 1-4  - Biomass
 `    - Floor
 ][   - Stairs


