LAND game map 48 x 14
Stage #11
                     
01234567890123456789012345678901234567890123456780
1][BBBBBBBBB        BCBBB][CB   BBB123412341234121
2][B CC BCCB      ][BBCCC][BB   BBBBBBBBBBBBBBBBB2
3][BBBBBBBBB][B```B][BBBBBC B   B1234BB CC    CC 3
4       BC B][     B][BBBBBB  ][BBBBBBBBBBB][BBWW4
5 BB   WBBBBBB][BBBBB][BBB` ][WW][    C    ][    5
6 BC  CW  BBBB][              ][B B   ][  B][    6
7 BC  CB    BBBBBBB][BBBBB``````   ```][`````    7
8 BB``BBC   W C C B][B         C      ][         8
9      WB  CBBBBBBB][BBBBB```BBB][C   ][B````B][C9
0 B1234 C  BW    C ][    C      ][    ][      ][ 0
1 BBBBBWB  CBC   BB][BBBBB```W     C          ][ 1
2      W   BBB1234 ][    CB  W  ``BBBB][1234  ][ 2 
3  ````WCCBBBBBBBBB][BBBBBB  W    BCB ][BBBB  ][ 3
4            BC B  ][     B123BB1234    C C C ][ 4
01234567890123456789012345678901234567890123456780

Legend 
=====================
 W    - Stone Wall
 B    - Brick wall
 C    - Chest
 1-4  - Biomass
 `    - Floor
 ][   - Stairs


