LAND game Map 50 x 16
Stage #3
CRC-32 76DD6C6F

{
#<>############  #############  ##################
#[]  $            % $ %              $  %% $     #
#[]####%%[]#  []^^^^^^#[]^^^^#  %%%%%%%%%%%%%%%[]#
#[]   $       []  %    []    $    []    []%% $$[]#
#[]^^^^^^^^############[]^^^^^^^^^[]^^######^^^^^#
#    %123412341     []   $        []   $       []#
#[]$ #^^^^^^^^#  #^^[]^^^^^^^^^^##^^^[]#####^^^[]#
#[]  # $            []               []   ##   []#
###[]#[]#12341#[]#  []   []^^^^###[]    $      []#
#  []   %%%%%%#[]#####   []       []^^^###[]^^^[]#
#  []  $             #   []^^^^###[]  $   []   []#
###[]^^^#[]#[]^^^^^[]    []       []^^^^####   []#
#  []    %%#[]  $  []#^^^^^^^^^^  []         ^^^^#
#  []^^^#$$########[]#            []^^^^^[]#     #
#  []   #%%%%%$%%%%[]#1234123412 $[] $   []#12341#
##################################################
}

Legend:
=====================
 # = Solid Wall
 % = Brick Wall
 $ = Chest
 1 = Biomass 1
 2 = Biomass 2
 3 = Biomass 3
 4 = Biomass 4
 ^ = Floor
 [ = Ladder Left
 ] = Ladder Right
 < = Exit Door Left
 > = Exit Door Right
