LAND game Map 50 x 16
Stage #12
CRC-32 88B54056

{
#<>############  #############  ##################
#[]              []  $ []            $$          #
#[]       ^^^[]  []^^^^[]  %%%%%[]#######[]  $   #
#[]####   ###[]  []    ####  #^^##%%$%[]#[]^^^   #
#[]  $$$$   #[]%%%         ^^   %%%%%%[]#[]      #
###[]########[]    []^^^#       %%%%%%[]##^^[] %%#
#  $ %12341234    []#   #  #[]^^^^^^^^^^ #  []   #
#$ []################ $ # $#[]    %$%$%% #  [] $ #
#  []% $ $ $ $  %%%%% $ %%%%[]  []^^^^^^^  []    #
#$ []#%%%%%%%%[]%%%%%^^^%%%%[]^^[] $ $ #  []     #
#  []#12341234[]$ $ %1234%      []^^^^^    []  $ #
#  []######################[]#^^########  []^^^^ #
#           $       $     %$ %            []     #
#[]^^[]####################^^^############[]#    #
#[]  []#   $ $ $  %       %      %  $ %   []%    #
##################################################
}

Legend:
=====================
 # = Solid Wall
 % = Brick Wall
 $ = Chest
 1 = Biomass 1
 2 = Biomass 2
 3 = Biomass 3
 4 = Biomass 4
 ^ = Floor
 [ = Ladder Left
 ] = Ladder Right
 < = Exit Door Left
 > = Exit Door Right
