LAND game map 48 x 14
Stage #12
                     
01234567890123456789012345678901234567890123456780
1][              ][  C ][           CC           1
2][       ```][  ][````][  BBBBB][WWWWWWW][  C   2
3][WWWW   WWW][  ][    WWWW  W``WWBBCB][W][```   3
4][  CCCC   W][BBB         ``   BBBBBB][W][      4
5WW][WWWWWWWW][    ][```W       BBBBBB][WW``][ BB5
6  C B12341234    ][W   W  W][`````````` W  ][   6
7C ][WWWWWWWWWWWWWWWW C W CW][    BCBCBB W  ][ C 7
8  ][B C C C C  BBBBB C BBBB][  ][```````  ][    8
9C ][WBBBBBBBB][BBBBB```BBBB][``][ C C W  ][     9
0  ][W12341234][C C B1234B      ][`````    ][  C 0
1    WWWWWWWWWWWWWWWWWWWWWW][W``WWWWWWWW  ][```` 1
2            C       C    BC B            ][     2 
3][``][WWWWWWWWWWWWWWWWWWWW```WWWWWWWWWWWW][W    3
4][  ][W    C C C  B      B      B  C B   ][B    4
01234567890123456789012345678901234567890123456780

Legend 
=====================
 W    - Stone Wall
 B    - Brick wall
 C    - Chest
 1-4  - Biomass
 `    - Floor
 ][   - Stairs


