LAND game Map 50 x 16
Stage #1
CRC-32 66741767

{
W<>WWWWWWWWWWWW  WWWWWWWWWWWWW  WWWWWWWWWWWWWWWWWW
W                                                W
W                                                W
W                                                W
W                                                W
W                                                W
W                                                W
W                                                W
W                                                W
W                                                W
W                                                W
W                                                W
W                                                W
W                                                W
W                                                W
WWWWWWWWWWWWWWWWWWWWWWWWWWWWWWWWWWWWWWWWWWWWWWWWWW
}

Legend
=====================
 W = Stone Wall
 B = Brick wall
 C = Chest
 1 = Biomass 1
 2 = Biomass 2
 3 = Biomass 3
 4 = Biomass 4
 ` = Floor
 ] = Stair Left
 [ = Stair Right
 < = Exit Door Left
 > = Exit Door Right
