LAND game Map 50 x 16
Stage #2
CRC-32 4D4989A4

{
W<>WWWWWWWWWWWW  WWWWWWWWWWWWW  WWWWWWWWWWWWWWWWWW
W][      CCCC W  W           W                   W
W][``````WWW][W  W   CCCCCCCCB][    ][     CCCC  W
W][         ][W  W  CBBBBBBBBB][  ][  ```````````W
W][         ][W  W CB         ][][               W
W][        C  W  WCB          ][                 W
W][           W  WB           ][                 W
W][  CCCC     B  BC           ][  B12 B1234123412W
W][````````][`W  W``][````````][` ``` ```````````W
W][        ][ W  W  ][        ][  BBB12341BBB123CW
W][        ][ W  WCC][        ][``` ``````` `````W
W][        ][ WCCWCC][        ][            CCCCCW
W][        ][ WCCW``][        ][         ][``````W
W][        ][ BCCBCC][        ][         ][      W
W][        ][ BCCBCC][12341234][         ][CCCCCCW
WWWWWWWWWWWWWWWWWWWWWWWWWWWWWWWWWWWWWWWWWWWWWWWWWW
}

Legend
=====================
 W = Stone Wall
 B = Brick wall
 C = Chest
 1 = Biomass 1
 2 = Biomass 2
 3 = Biomass 3
 4 = Biomass 4
 ` = Floor
 ] = Stair Left
 [ = Stair Right
 < = Exit Door Left
 > = Exit Door Right
