LAND game Map 50 x 16
Stage #3
CRC-32 4E6347DC

{
W<>WWWWWWWWWWWW  WWWWWWWWWWWWW  WWWWWWWWWWWWWWWWWW
W][            WW             WW               ][W
W][                   C C                      ][W
W ][   CC          ][BBCBB][         CCC      ][ W
W   ][ `` ][     ][         ][     ][```][CC][   W
W       ``  ][ ][    B C B    ][ ][       ``     W
W    C       ][ CCBBBBB BBBBBCC ][               W
W   CCC      ][CBBBB C   C BBBBC][        CC     W
W  CCCCC   ][C BBB C  C C  C BBB C][  C        C W
W       C ][  `B  ```````````  B`  ][  B12CC12B  W
W][ ```` ][    BB1234123412341BB    ][ BBB][BBB  W
W][       ][  CBBB```````````BBBC  ][     ][     W
W][         ][ BBBBB C C C BBBBB ][       ][     W
W][        ][   CBBBBBBBBBBBBBC   ][      ][     W
W][  B1234B ][ CCB1C3412341C3BCC ][       ][     W
WWWWWWWWWWWWWWWWWWWWWWWWWWWWWWWWWWWWWWWWWWWWWWWWWW
}

Legend
=====================
 W = Stone Wall
 B = Brick wall
 C = Chest
 1 = Biomass 1
 2 = Biomass 2
 3 = Biomass 3
 4 = Biomass 4
 ` = Floor
 ] = Stair Left
 [ = Stair Right
 < = Exit Door Left
 > = Exit Door Right
