LAND game Map 50 x 16
Stage #5
CRC-32 D30F35BA

{
W<>WWWWWWWWWWWW  WWWWWWWWWWWWW  WWWWWWWWWWWWWWWWWW
W][          ][  ][         ][  ][ C         C ][W
W][          ][  ][   ][B   ][  ][             ][W
W  ````````` ][  ][ ``   `` ][  ][ `````````][`  W
WCC          ][  ][C C C C C][  ][          ][   W
W            ][BB][         ][  ][BBB      C C12CW
WBB          ][  ][    C    ][  ][BCB        BBBBW
W            ][  ][BB23412BB][  ][BBBC   C  C    W
WC  ][ WB`B`````W][ `B```B` ][```````````````````W
W12][  WC BB CC W][    C    ][  CC  C      CC  CCW
WB][   WB CB ][ W][  W   W  ][  ][`` ][ CCC  CC  W
W][    WC WB ][ W][  BBBBB  ][  ][    ][   ][``BBW
W][    WB CB ][ W][         ][  ][     ][  ][    W
W][    B123B ][  ][         ][  ][  CC  ][C][C   W
W   ][BB][BBB][BB][ BB C BB ][BB][BBBBBBB12341B  W
WWWWWWWWWWWWWWWWWWWWWWWWWWWWWWWWWWWWWWWWWWWWWWWWWW
}

Legend
=====================
 W = Stone Wall
 B = Brick wall
 C = Chest
 1 = Biomass 1
 2 = Biomass 2
 3 = Biomass 3
 4 = Biomass 4
 ` = Floor
 ] = Stair Left
 [ = Stair Right
 < = Exit Door Left
 > = Exit Door Right
