LAND game Map 50 x 16
Stage #11
CRC-32 4871B104

{
W<>WWWWWWWWWWWW  WWWWWWWWWWWWW  WWWWWWWWWWWWWWWWWW
W][                                           C  W
W][                                          ``][W
W````][`````````````````BBBB```````````````][  ][W
W                       B CB               ][  ][W
W    ][``               BC B               ][  ][W
WCBBB][   C     BBBBBBBBB``BBBBBBBBB       ][  ][W
W    ][         B C C C C  C C C C B       ][  ][W
W    ][         BBBBBBBBB``BBBBBBBBB````   ][  ][W
W  ``````][    C    C   B CB               ][  ][W
W C      ][````````     BC B     ][````````][  ][W
W        ][             B CB     ][W       BB C][W
W C      ][             BC B     ][     W````````W
W   ][```````````][     B CB     ][              W
W   ][W123412341W][     BC B     ][W1234123412341W
WWWWWWWWWWWWWWWWWWWWWWWWWWWWWWWWWWWWWWWWWWWWWWWWWW
}

Legend
=====================
 W = Stone Wall
 B = Brick wall
 C = Chest
 1 = Biomass 1
 2 = Biomass 2
 3 = Biomass 3
 4 = Biomass 4
 ` = Floor
 ] = Stair Left
 [ = Stair Right
 < = Exit Door Left
 > = Exit Door Right
