LAND game Map 50 x 16
Stage #12
CRC-32 2AE0C96F

{
W<>WWWWWWWWWWWW  WWWWWWWWWWWWW  WWWWWWWWWWWWWWWWWW
W][      C                       CBBCBBBBBBBBCBBCW
W][][WWWWW         ][WW][WW][     ```````][````  W
W  ][              ][WW][WW][            ][      W
W  ][````````````````BB][BB``````````````][````  W
W  ][              B123WW                    CB  W
W  ][````````      BBBB][BBBB       C      ][BB  W
W  ][     BBB   BBBBBC ][ CBBBBB  ][```][  ````][W
W  ][      C     BBBB``][``BBBB        ][      ][W
W  ][     BBB  BBBBBBC ][ CBBBBB       ][``````][W
W  ][     BCB     BBB``][``BBB   C  C          ][W
W  ][     WWW```WWBBBC ][ CB][  ][```````W   ][][W
W  ][              BBB`][``B][  ][           ][  W
W  ][```````````][     ][   ][  ][           ][  W
W  ][W123412341WWWWWW1234123WWWWWW1234123412W][  W
WWWWWWWWWWWWWWWWWWWWWWWWWWWWWWWWWWWWWWWWWWWWWWWWWW
}

Legend
=====================
 W = Stone Wall
 B = Brick wall
 C = Chest
 1 = Biomass 1
 2 = Biomass 2
 3 = Biomass 3
 4 = Biomass 4
 ` = Floor
 ] = Stair Left
 [ = Stair Right
 < = Exit Door Left
 > = Exit Door Right
