LAND game Map 50 x 16
Stage #13
CRC-32 C67F08C5

{
W<>WWWWWWWWWWWW  WWWWWWWWWWWWW  WWWWWWWWWWWWWWWWWW
W][           B C             C                  W
W][BBBBBBBBBBBW``BBB][WW][BBBB``WWWB][BBBBBB][B CW
W][ C C C C   BC ```][  ][```` CB  B][  W  C][WC W
W  ``````` C  B CB C][``][   BC B  B][  WC B][W CW
WC    C     C BC B    C      B CB  B][  WB C][WC W
W`````````````B``B```````````BC B  B][  WC B][W CW
W         C   BC    C  C   C    B  B][  WB C][WC W
W123412341][  B CB```````````WWWW  B][  WC B][W CW
WWWWWWWWWW][  BC               C   B][  WB C][WC W
WBB  BBBBB][```WW``][``][````WWWW``B][``WC W][W CW
WCB][WC CW][       ][C ][  C        ][ CWBBB][ C W
W  ][W C W][```````][``][``````WW```][``WWWW][C CW
W``][WC CW][                        ][      ][ C W
W  ][W C  ][123412341234123412341234][123412][CCCW
WWWWWWWWWWWWWWWWWWWWWWWWWWWWWWWWWWWWWWWWWWWWWWWWWW
}

Legend
=====================
 W = Stone Wall
 B = Brick wall
 C = Chest
 1 = Biomass 1
 2 = Biomass 2
 3 = Biomass 3
 4 = Biomass 4
 ` = Floor
 ] = Stair Left
 [ = Stair Right
 < = Exit Door Left
 > = Exit Door Right
