LAND game Map 50 x 16
Stage #14
CRC-32 10501F3F

{
W<>WWWWWWWWWWWW  WWWWWWWWWWWWW  WWWWWWWWWWWWWWWWWW
W][][BBBBC    C  C       C                  C][][W
WC ][BBBBB    W][W   B123][  BBBB  B12341234123][W
W CWWWWWWW][  W][W   WWWW][  W  W  ][WWWWWW```WC W
WC W C    ][  B][B       ][        ][BBBBBBBC W CW
W CWC WWWWWWWWW][BBBBWWWWWWBB][WWWWWWWWWWWWB CWC W
WC W CW  B123412341  C       ][BBBC  CBBB  BCBW CW
W CWC W  WWWWWWWWWW  WWWWWW``][WWWWWWWWWW  B CWC W
WBB                C         ][         W][````  W
WC `````````][WWWWW``WWWWWW``WWWWWWWWW][W  W  W CW
W CW  B1234B][          B C  C     C W][ CC   WC W
WC W  WWWWWW][BBBWW``][WWBBBBBBB][W  W][WWWWCCB CW
W CB12341234][ C ][BB][BB12341BB][C CW][BBBBBBWC W
WC WWWWWWWWW][BBB][BCWWW `````BB][WWWW][WWWWCCW CW
W        BBB][123][BBBBB       BBBBBBBCBBBBCBBB  W
WWWWWWWWWWWWWWWWWWWWWWWWWWWWWWWWWWWWWWWWWWWWWWWWWW
}

Legend
=====================
 W = Stone Wall
 B = Brick wall
 C = Chest
 1 = Biomass 1
 2 = Biomass 2
 3 = Biomass 3
 4 = Biomass 4
 ` = Floor
 ] = Stair Left
 [ = Stair Right
 < = Exit Door Left
 > = Exit Door Right
