LAND game Map 50 x 16
Stage #15
CRC-32 A644674E

{
W<>WWWWWWWWWWWW  WWWWWWWWWWWWW  WWWWWWWWWWWWWWWWWW
W][  B123412341                 BB C    C  C C BBW
W][` ``````````  B12341234123``````` ][```````W  W
W][  C C       C BBBBBBBBBBBBB  C   ][BB C C C BBW
WBBBBBBBBB][  ```````````````````` ][BBBBBBBBBW``W
WCCW  BCBBB][    B12341234123B    ][ W C C C C   W
W    CW][```][BBBBBBBBBBBBBBBBBBB][ BBBBBBBBBBW``W
WCCW  ][         B12341234123B    ][   C C C C   W
W   C W][ C    ][BBBBBCCBBBBBB][    ````````BBB][W
WCCW  ][     ][  C C C   C C C  ][      B123C B][W
W          ][BBBBBBBBBB][`````````][    BBBBBBB][W
W  W```  ][BBC C C C CB][BBC C C CBB][      C B][W
WCCB   ][``````````````][`````````````][    ```][W
WBB  ][                                 ][     ][W
W  ][1234123412341234123412341234123412341][   ][W
WWWWWWWWWWWWWWWWWWWWWWWWWWWWWWWWWWWWWWWWWWWWWWWWWW
}

Legend
=====================
 W = Stone Wall
 B = Brick wall
 C = Chest
 1 = Biomass 1
 2 = Biomass 2
 3 = Biomass 3
 4 = Biomass 4
 ` = Floor
 ] = Stair Left
 [ = Stair Right
 < = Exit Door Left
 > = Exit Door Right
