LAND game Map 50 x 16
Stage #17
CRC-32 2C9E2210

{
W<>WWWWWWWWWWWW  WWWWWWWWWWWWW  WWWWWWWWWWWWWWWWWW
W][   C       C       C     ][    C             CW
W][ BBBBB   BBBB```BBBBBB ``][```   ````` ][ ``  W
W][B   BB  BB  BB  BB   BB  ][       C   ][][   CW
W][B C BB  BB C    BB C BB  ][   `````` ][BB][   W
W][BBBBBB```BBBB```BBBBBB   ][ C       ][BCBB][  W
W  B   BB      BB  BB       ][``````  ][BB CBB][ W
W  B C BB  BBC BB  BB BBBBBB][       ][BB C CBB][W
W  B C BB   BBBB   BB B C C ][      ][BB C C BB][W
W                     B  C  ][     ][BB C C CBB][W
W][````````````][```````````][`````````````````][W
W][  C C    BBB][ BB C B BB CBBB    B   C  C C ][W
W][``````  B   ``B  B``BB````B  B   B``````````][W
W][        B C   B CB  B     BBB    B          ][W
W][      C  BBB C BB   B C   B C  B341234123412][W
WWWWWWWWWWWWWWWWWWWWWWWWWWWWWWWWWWWWWWWWWWWWWWWWWW
}

Legend
=====================
 W = Stone Wall
 B = Brick wall
 C = Chest
 1 = Biomass 1
 2 = Biomass 2
 3 = Biomass 3
 4 = Biomass 4
 ` = Floor
 ] = Stair Left
 [ = Stair Right
 < = Exit Door Left
 > = Exit Door Right
