LAND game Map 50 x 16
Stage #8
CRC-32 EE39368D

{
#<>############  #############  ##################
#[]      $$  $       $$                $$        #
#[]^^^^^^^^  ^^^^^^^^^^^^^^^^^^^^^^[]  ^^^^^^^^[]#
#[]         %    $           $     []          []#
#  ^^[]     %^^^^^^^^^^^^^^^^^^^   []          []#
#      ^^[]          $$         %  []          []#
#  %%    []     %^^^^^^^^^^^^^^^%  []        $ []#
#$         ^^[]        $$          []  []^^^^^^[]#
#^^^^^^^^^^^^[]^^^^^^^^^^^^^^      []  []  $$    #
#  $         []            $       []%   ^^^^^^[]#
#$$      []^^[]    []^^^^^^^^^^^^^^            []#
#  $ []^^    []]$  []      []%                 []#
#    []      ^^^^^^  ^^^^^^      $$          $ []#
#[]^^                         %^^^^^^^^^^^^^^^^  #
#[]1234123412341234123412341234123412341234123412#
##################################################
}

Legend:
=====================
 # = Solid Wall
 % = Brick Wall
 $ = Chest
 1 = Biomass 1
 2 = Biomass 2
 3 = Biomass 3
 4 = Biomass 4
 ^ = Floor
 [ = Ladder Left
 ] = Ladder Right
 < = Exit Door Left
 > = Exit Door Right
