LAND game Map 50 x 16
Stage #9
CRC-32 99623B60

{
#<>############  #############  ##################
#[]##      $$      $$        $         $$    %%  #
#[]##  %%%%%%%%%%%%%%%%%%%%%%%%%%%%%%%%%%%%%%%%[]#
#[]##  %% $      $    $    %12341 $            []#
#[]##  %%[]^^[]^^%%^^%%  []^^^^^^[] $      $$  []#
#[]##  %%[]%%[]$ %%$ %%%%[]  $$    ## $       $[]#
#[]##  %%[]%%[]$$%%  %%  []^^^^^^^^  [] $      []#
#[]##  %%[]%%[] $%%  %%  []            ## $    []#
#[]##  %%[]%%[]$ %% $%%$$[]12341234123412[]  []  #
#[]##$$$$[]%%[]  %%  %%%%[]^^^^^^^^^^^^^^  []    #
#[]##%%%%%%%%%%%%%%    %12341234123412341[]  $$  #
#[]$                 []%%%%%%$%%%%%%%%%[]  ^^^^  #
#[]      $ %123412341[]#            $[][]$   $$  #
#  ^^[]%%%%%%%%%%%%$%%%#   $$   $    []^^^^^^^^  #
#    []##        %123   ^^^^^^^^^^^[]123412341234#
##################################################
}

Legend:
=====================
 # = Solid Wall
 % = Brick Wall
 $ = Chest
 1 = Biomass 1
 2 = Biomass 2
 3 = Biomass 3
 4 = Biomass 4
 ^ = Floor
 [ = Ladder Left
 ] = Ladder Right
 < = Exit Door Left
 > = Exit Door Right
