LAND game Map 50 x 16
Stage #2
CRC-32 197D4E2E

{
#<>############  #############  ##################
#[]%%%%%%%%%        %$%%%[]$%   %%%12341234123412#
#[]% $$ %$$%      []%%$$$[]%%   %%%%%%%%%%%%%%%%%#
#[]%%%%%%%%%[]%^^^%[]%%%%%$ %   %1234%% $$    $$ #
#       %$ %[]     %[]%%%%%%  []%%%%%%%%%%%[]%%###
# %%   #%%%%%%[]%%%%%[]%%%^ []##[]    $    []    #
# %$  $#  %%%%[]              []% %   []  %[]    #
# %$  $%    %%%%%%%[]%%%%%^^^^^^   ^^^[]^^^^^    #
# %%^^%%$   # $ $ %[]%         $      []         #
#      #%  $%%%%%%%[]%%%%%^^^%%%[]$   []%^^^^%[]$#
# %1234 $  %#    $ []    $      []    []      [] #
# %%%%%#%  $%$   %%[]%%%%%^^^#     $          [] #
#      #   %%%1234 []    $%  #  ^^%%%%[]1234  [] #
#  ^^^^#$$%%%%%%%%%[]%%%%%%  #    %$% []%%%%  [] #
#            %$ %  []     %123%%1234    $ $ $ [] #
##################################################
}

Legend:
=====================
 # = Solid Wall
 % = Brick Wall
 $ = Chest
 1 = Biomass 1
 2 = Biomass 2
 3 = Biomass 3
 4 = Biomass 4
 ^ = Floor
 [ = Ladder Left
 ] = Ladder Right
 < = Exit Door Left
 > = Exit Door Right
