LAND game map 48 x 14
Stage #1

{                     
W<>WWWWWWWWWWWWWWWWWWWWWWWWWWWWWWWWWWWWWWWWWWWWWWW
W][ CC            CC           CC              WWW
WC ][``````````````````````````````````````````WWW
WBB][   CC    C         CC        C  C       CC  W
WC ][B][BBBBBBBBBBBBBBBBBBBBBBBBBBBBBBBBB][BB    W
W  ][WBBB  C         C         C         ][BB``  W
WC ][W  W][W][BBBBBBBBBBBBBBBBBBBBBBBBBBB  BBCC  W
W  ][WCCW][    CC          CC           CC BB    W
WC ][W  W][          C         C         CCBB  CCW
W  ][WC W  BBBBBBBBBBBBBBBBBBBBBBBBBBBBBB][BB    W
WC ][W  WCC                    CC        ][BB1234W
W<>WWW CW    CC            C           C ][BBBBBBW
W][ C C  ][``````````````````````````````    CC  W
W][````  ][            C   B1234123412341][``````W
W][  C   ````````][`````BB```````````````][   C  W
WWWWWWWWWWWWWWWWWWWWWWWWWWWWWWWWWWWWWWWWWWWWWWWWWW
}

Legend 
=====================
 W    - Stone Wall
 B    - Brick wall
 C    - Chest
 1-4  - Biomass
 `    - Floor
 ][   - Stairs
