LAND game map 48 x 14
Stage #2
                     
01234567890123456789012345678901234567890123456780
1][                                              1
2][  C   C   C BBC           CBB C   C   C   CC  2
3][``````````````````````][````````````````````  3
4][    C   C   C   C     ][    C   C   C   C     4
5][``````````````````````][````````````````````][5
6][  C   C   C   C       ][   C   C   C   C    ][6
7  ``````````````````````][````````````````````][7
8      C   C   C   C     ][    C   C   C   C   ][8
9][``````````````````````][````````````````````][9
0][  C   C   C   C       ][  C   C   C   C     ][0
1][``````````````````````][````````````````````  1
2][    C   C   C   C     ][    C   C   C   C   CC2 
3][````````````````````````````````````````````WW3
4][12341234123412341234123412341234123412341234WW4
01234567890123456789012345678901234567890123456780

Legend 
=====================
 W    - Stone Wall
 B    - Brick wall
 C    - Chest
 1-4  - Biomass
 `    - Floor
 ][   - Stairs


