LAND game map 48 x 14
Stage #9
                     
01234567890123456789012345678901234567890123456780
1][ C     CC    C    CC               C][][  CC  1
2  ``][````````````][  C ][  C  C C C    ][````][2
3  C ][  C    C  C ][````  ``````````````  CCCC][3
4CC  ][``````][    ][    CC       C   C      ][ C4
5      CC  C ][``][  ][C   C   ][````````````  ][5
6C ][````````  CC][  C ``````][   C  CC    C  ][C6
7][ C   C    C   ][    C   C ][    C    C    ][  7
8][  ][``````````  ```][`````  ``````][````][   C8
9][  ][  C C C       ][       CC    C    C ][  C 9
0  ][  ````````][ C ][ C ][``````][````````  ][  0
1CC][            ``][ ```][           C   C  ][  1
2  ][       C   C  ][ CC ][ C    C ][``````][    2 
3][  ``````````````  ````  ````````          ][CC3
4][12341234123412341234123412341234123412341234WW4
01234567890123456789012345678901234567890123456780

Legend 
=====================
 W    - Stone Wall
 B    - Brick wall
 C    - Chest
 1-4  - Biomass
 `    - Floor
 ][   - Stairs


