LAND game Map 50 x 16
Stage #2
CRC-32 3A44E1E1

{
W<>WWWWWWWWWWWW  WWWWWWWWWWWWW  WWWWWWWWWWWWWWWWWW
W][               C         C     CC       C ][CCW
W][````][ C  WW``WWW][WW][WWWWWWCC][CC    CBB][BBW
WWWWW  WWWW][           ][      ][  ][         ][W
W  BB34C234][      C    ][      WWWW][`````````][W
W][BBWWWWBBBB   C][W][``  ``                W  ][W
W][          C C  WW][        WWWWWWWWWWWW][W][WWW
W][WWWW][WW`````    ][    WW C C  C       ][W][  W
W][W   ][       C CB][C C BBBBBB][```     ][W][CCW
W][  C ][ C    `````WWWWWW][    ][        ][W  ][W
W][  ][``][        C  C C ][    ][BBB````WWWW  ][W
W][  ][  ][       C   ````][C C ][CCB341234  C ][W
W][  ][  ][ C       C    CWWWWWW][  BBBBBBBBBBB][W
W  ][      ][        C          ][CC     WW  ][  W
W  ][  WW  ][412    C           ][       BBC ][ CW
WWWWWWWWWWWWWWWWWWWWWWWWWWWWWWWWWWWWWWWWWWWWWWWWWW
}

Legend
=====================
 W = Stone Wall
 B = Brick wall
 C = Chest
 1 = Biomass 1
 2 = Biomass 2
 3 = Biomass 3
 4 = Biomass 4
 ` = Floor
 ] = Stair Left
 [ = Stair Right
 < = Exit Door Left
 > = Exit Door Right
