LAND game Map 50 x 16
Stage #3
CRC-32 6FFEABC5

{
W<>WWWWWWWWWWWW  WWWWWWWWWWWWW  WWWWWWWWWWWWWWWWWW
W][  C  C    C    C         C    C        C  C ][W
W][WWW  WWWWWWWWWWWWWWWWWWWWWW][WWWWWWWWWWW  WW][W
W][W][CC][     ][             ][              W][W
W][W][``][   C ][     C C     ][ C ][````     W][W
W][W][  ][  ```  ``][`````][``  ```][  C      B][W
W][W][CC][  C      ][  C  ][       ][  WW`````W][W
W][B][``BBBBB C    ][`````][ C C   ][     C   W][W
W][W   C    BBBC ``][ C C ][````   ][    WW   W][W
W][W  WW  ][`````  ][`````][       ][  C     CW][W
W][WC     ][44123412341234123412343][  WW  WWWW][W
W][WWW    ][WWWWWWWWWWWWWWWWWWWWWWW][         W][W
W][B C  C ][ C WW   C C C C   WW CB][  C BB C W][W
W][WWWWWWWWWWWWWW][WWWWWWWWW][WWWWWWWWWWWWWWWWW][W
W][   C    C     ][234123412][     C      C    ][W
WWWWWWWWWWWWWWWWWWWWWWWWWWWWWWWWWWWWWWWWWWWWWWWWWW
}

Legend
=====================
 W = Stone Wall
 B = Brick wall
 C = Chest
 1 = Biomass 1
 2 = Biomass 2
 3 = Biomass 3
 4 = Biomass 4
 ` = Floor
 ] = Stair Left
 [ = Stair Right
 < = Exit Door Left
 > = Exit Door Right
