LAND game Map 50 x 16
Stage #3
CRC-32 C2D178C0

{
W<>WWWWWWWWWWWW  WWWWWWWWWWWWW  WWWWWWWWWWWWWWWWWW
W][  C            B C B              C  BB C     W
W][WWWWBB][W  ][``````W][````W  BBBBBBBBBBBBBBB][W
W][   C       ][  B    ][    C    ][    ][BB CC][W
W][````````WWWWWWWWWWWW][`````````][``WWWWWW`````W
W    B123412341     ][   C        ][   C       ][W
W][C W````````W  W``][``````````WW```][WWWWW```][W
W][  W C            ][               ][   WW   ][W
WWW][W][W12341W][W  ][   ][````WWW][    C      ][W
W  ][   BBBBBBW][WWWWW   ][       ][```WWW][```][W
W  ][  C             W   ][````WWW][  C   ][   ][W
WWW][```W][W][`````][    ][       ][````WWWW   ][W
W  ][    BBW][  C  ][W``````````  ][         ````W
W  ][```WCCWWWWWWWW][W            ][`````][W     W
W  ][   WBBBBBCBBBB][W1234123412 C][ C   ][W12341W
WWWWWWWWWWWWWWWWWWWWWWWWWWWWWWWWWWWWWWWWWWWWWWWWWW
}

Legend
=====================
 W = Stone Wall
 B = Brick wall
 C = Chest
 1 = Biomass 1
 2 = Biomass 2
 3 = Biomass 3
 4 = Biomass 4
 ` = Floor
 ] = Stair Left
 [ = Stair Right
 < = Exit Door Left
 > = Exit Door Right
