LAND game Map 50 x 16
Stage #9
CRC-32 D68E69F3

{
W<>WWWWWWWWWWWW  WWWWWWWWWWWWW  WWWWWWWWWWWWWWWWWW
W][                 C  C  C     C    C     C  C  W
W  ][  C      BB  BBBBBBBBBB````````````][`````  W
W  BBBB][     C   B12341234B            ][       W
W  ][  ][    ```` BBBBBBBBBB   ][``````````````][W
W  ][    ][                    ][ C  C  C        W
W  ][ C C  ][                  ][````````][    C W
W  ][````    ][   C   C   C   C          ][  BBWWW
W  ][    ][``````````````````````````````][BB    W
W  ][ C  ][ C  C  C           C   C   C   C      W
W  ][``  ][``````````][    ][````````````````][  W
W      C  C  C  C    ][````][       C   C    ][  W
W  ][`````````````][            ][```````````][  W
W  ][             ][````````````][               W
W  ][12341234123412341234123412341234123412341W  W
WWWWWWWWWWWWWWWWWWWWWWWWWWWWWWWWWWWWWWWWWWWWWWWWWW
}

Legend
=====================
 W = Stone Wall
 B = Brick wall
 C = Chest
 1 = Biomass 1
 2 = Biomass 2
 3 = Biomass 3
 4 = Biomass 4
 ` = Floor
 ] = Stair Left
 [ = Stair Right
 < = Exit Door Left
 > = Exit Door Right
