LAND game Map 50 x 16
Stage #15
CRC-32 2DBA991B

{
W<>WWWWWWWWWWWW  WWWWWWWWWWWWW  WWWWWWWWWWWWWWWWWW
W][      C    C                   C BB   C   CC  W
W][WWWWWWWWWWWW          CBBBBW```````][WW   ``][W
W][  B123412         C            B123][       ][W
W][  BBBBBBB][BB][``````BBBBBBBB][``````       ][W
W][  BBC   CBB  ][              ][     C       ][W
W][  BBBBBBB][  ][   C          ][    ```W     ][W
W][  BBC   CBB  ][``````W       ][     C       ][W
W][  BBBBBBB][  ][           C  ][  W``````    ][W
W][  BBC   CBB  ][       W``````][      C      ][W
W][  BBBBBBB][  ][   C          ][    ``````W  ][W
W][```````````  ][``````W       ][       C     ][W
W               ][      C       ][  W``````````][W
W][`````````````][      W```````][BB           ][W
W][1234123412 C ][1234123412341234123412341234123W
WWWWWWWWWWWWWWWWWWWWWWWWWWWWWWWWWWWWWWWWWWWWWWWWWW
}

Legend
=====================
 W = Stone Wall
 B = Brick wall
 C = Chest
 1 = Biomass 1
 2 = Biomass 2
 3 = Biomass 3
 4 = Biomass 4
 ` = Floor
 ] = Stair Left
 [ = Stair Right
 < = Exit Door Left
 > = Exit Door Right
